  $
 #######
 #     #
 #   ###
 #   # #
 ### # #
 # # #
   #
