#### # 
  # ###
# # #
##### #
# # ###
 ### #
#$ ###
